157 31
#################      ###################                                                             #####                                            ;;;;;
#...............#      #.................#                                                             #...#                                            ;,,,;
#...............#      #.................#                                                             #...#                                            ;,,,;
#...............########.................#                                                             #...#                                            ;,,,;
#........................................#                                                             ##.##                                            ;;;;;
#...............########.................#                                                              #.#
#...............#      #.................#                                                              #.#
######.##########      #.................#                                                              #.#
     #.#               #######.###########                                                              #.#
     #.#                     #.#                                                                        #.#
######.########       ########.##########    ##############                                             #.#                 ###############
#.............#       #.................#    #............#                                             #.#                 #.............#
#.............#       #.................######............#                                       #######.#########         #.............#
#.............#########...................................#                           #######     #...............#         #.............#
#.......................................######............#       #######             #.....#     #...............#         #.............#
#.............#########.................#    #............#########.....#             #.....#######...............###########.............#
#.............#       #.................#    #..........................#             #...................................................#
#.............#       #.................#    #............#########.....#             #.....#######...............###########.............#
###############       #######.###########    ##############       #######             #######     #...............#         #.............#
                            #.#                                                                   #...............#         #.............#
                            #.#                                                                   #...............#         #.............#
                            #.#                                                                   #######..########         ###############
                         ####.#####                                                                     #..#
                         #........#                                                                     #..#
                         #........#                                                               #######..#######
                         #........#                                                               #..............#
                         ##########                                                               #..............#
                                                                                                  #..............#
                                                                                                  #..............#
                                                                                                  #..............#
                                                                                                  ################